                                                                                    
                                                                                    
                                                                                    
                                                                                    
                                                                                    
                                                                                    
                                                                                    
                                                                                    
                                                                                    
                                                                                    
                                                                                    
                                                                     # # ###        
                                                                     # #   #        
                                                                     # ### ##### #5#
                                                                     # # # #     #9#
                                                                     # # # # #####2#
                                                                     # # #   #   #0#
                                                                     # # ##### # #4#
                                                                     # # # #   # #1#
                                                                     # # # # # # #0#
                                                 #   #               # # #   # # #7#
                                               # ### #       ### # # # # ##### # #2#
                                               # # # #       #   # # # #     # # #a#
                                         # # # # #x# #     ### ### ### ### ### ###2#
                                           #     # #       #   # #     # #   #   #6#
                                         # ####### # #     # ### ##### # ### ### #6#
                                         # #     # # #     # #   #   # #   # #   #9#
                                         ### ### # # #     # # ### # ### # # # ###e#
                                           #   #   #         #   # #   # #     # #c#
                                         # ### # ### ###   ### # # ### ##### ### #d#
                                         #   # #     #       # #   #       # #   #7#
                                         ### # ####### #   # ####### ##### # # # #3#
                                             # #     #     #       # #       # # #4#
                                     # # # ### # ### ##### ####### ### ####### ###a#
                                     #   #   #   #   #   #         #   #     #   #e#
                                     ####### # ### ##### #   ####### ### ### ### #f#
                                       #   #   # # #   # #     #     #   #     # #4#
                                     # # # # ### # # # # ##### # ##### ### ### # #3#
                                       # #   # # # # # #       #       # # #   # #6#
                                     ### ##### # # ### ############# ### # # ### #a#
                                       #   #   #     #   #   #     # #     #   # #6#
                                     # ##  # ##### # # # # ### # # # # ####### # #8#
                                       # # #   #   #   # #   # # #   #   #   #   #9#
                                     ### # ### # ### ### ### # ######### ### # # #a#
                                       #   # #     # #       # #         #   # # #d#
                                       ##### ##### # # ####### # ######### # # # #4#
                                               #   # #         #       #   # # # #2#
                                           ### # ##################### # ##### # #a#
                                           #   #     #   #     #   # # # #   # # #3#
                                         ### ####### # # # ##### # # # # # # # # #5#
                                         #   #       # # #   #   # #     # #   # #7#
                                         # ### ####### # ### # ### ### ### ##### #8#
                                         # #     #     # #   #   #     # #   #   #d#
                                         # ### # # ##### # ##### ####### ### # ###2#
                                         #   # # #   #   # #     #       #   #   #6#
                                         ### ### ### ##### # ### # ####### ##### #7#
                                           #   #   # #     #   # # #     #     # #0#
                                           ### ### # # # ##### ### ##### ##### # #b#
                                           #   #   #   # #   #   #     # # #   # #7#
                                           # ### # ##### # ##### ##### # # # #####0#
                                             #   #     # #       #   #     #     #7#
                                           ### ####### # ######### ##### ####### #9#
                                             #       # # #   #   #   #   # #     #8#
                                           # ####### # # ### # # ### # # # # #####6#
                                           # #     # # #     # # #   # #   #     #f#
                                           # # ### # ### ##### # # ####### # ### #5#
                                           # #   # #   #   #   #   #       #   # #4#
                                           # ### # # # ### # ##### # # ######### #5#
                                               # # # #   # # #   # # # #   #     #f#
                                           ### # ### # # # # # # # # ### # # #####b#
                                               #     # #     # #   #     #   #   #d#
                                             ####### # ### ################# # # #a#
                                                   # #   #         #   #     # # #c#
                                             ### # ##### ##### ### # # # ####### #b#
                                                 # #   # #     #     # # #       #d#
                                                 # # # ### ############# # # #####e#
                                                     #   #             # # #   # #a#
                                                     ### ############# # # ### # #7#
                                                       # #      #      # #   # # #7#
                                                       # # ############# ### # # #4#
                                                       # #                   #   #4#
                                                       ###########################c#
                                                       135b326d0c92915a9a404a42ef0d#
                                                       #############################